111111111111111111111111111111111111111111111111111111111111111111
1P0000000000000C00000000000000000000000000000000C00000000000000001
111111111110000000000011111111111111111111110000000000011111111111
100000000000000000000000000000001100000000000000000000000000000001
100000000001111111111100000000001100000000001111111111100000000001
1000000000000000000000000000000000000000000000000C0000000000000001
100000000000000000000000000000000000000000000000000000000000000001
100000000000001111000000000000001100000000000001111000000000000001
1000000C00000011110000000C00000011000000C0000001111000000C00000001
100000000000001111000000000000001100000000000001111000000000000001
100000000000000000000000000000000000000000000000000000000000000001
100000C0000000000000000000C0000000000000000000C0000000000000000001
10000000000111111111110000000000110000000000111111111110000000E001
100000000000000000000000000000000000000000000000000000000000000001
1000000000000000000000000000000000000000000000000C0000000000000001
111111111110000000000011111111111111111111110000000000011111111111
100000000000C00000000000000000000C000000000000000000000000000000E1
111111111111111111111111111111111111111111111111111111111111111111